# Preguntas Clave


¿Cuál es el rendimiento de cada operador?
¿Cuál es la cantidad de TICKETS que se hacen semalmente? ¿Qué día tienen mejor rendimiento?
Predictores - ¿Cuáles van a ser las ventas mensual, trimestral de 2018?
¿Cuál es la referencia, color, cliente y ciudad que más compró?
Mapa de calor - La demanda de referencias a lo largo del año
Determinar las Referencias más demandadadas por Ciudad



# Decodificacion de Columnas
CODCLI = 'Codigo de Cliente'
CODART = 'Codigo de Articulo'
CODPP  = 'Codigo Procesos de Produccion'
CODOPE = 'Codigo de Procesos'
CANVEN = 'Cantidad Pedido'
CANOPESE = 'Cantidad Operaciones Sin Elaborar'
CANOPE = 'Cantidad Operaciones'
CANOPESEA = 'Cantidad Operaciones sin Elaborar Alta'
COSTOOPE = 'Costo Operacion Cuando se Crea'
COSTOOPEC = 'Costo Operacion'
TICKET = 'Codigo de Barras Ticket'
NROORDP = 'Número de Pedido'
NROINV = 'Número de Plantilla o Lote'
FECINV = 'Fecha Plantilla'
NROPLA = 'Número de Planificacion'
FECPLA = 'Fecha Planificacion'
FECHATICK = 'Fecha cuando se guarda el Ticket'
HORATICK = 'Hora cuando se guarda el Ticket'
CODPER = 'Codigo Personal'
FECHAITT = 'Fecha Inicio Tarea'
HORAFTT = 'Hora Fin Tarea'
CODOPEPTT = 'Codigo de Operacion Parada'
FECHAPTT = 'Fecha Tarea Parada'
HORAPTT = 'Hora Tarea Parada'
STATUSN = 'Estado Nomina'
FECHAIOPE = 'Fecha Inicio Operacion'
HORAIOPE = 'Horario Inicio Operacion
FECHAFOPE = 'Fecha Fin Operacion'
HORAFOPE = 'Hora Fin Operacion'
NROFACT = 'Número Factura'
FECFACT = 'Fecha Factura'
STATUSF = 'Estado si es 0 se facturo todo'
CANTICKIMP = 'Cantidad Tickets Impresos'
FECTICKIMP = 'Fecha cuando se imprime el Ticket'
DESNMAT1 = 'Nota Material 1'
FECHA = 'Fecha'
HORA = 'Hora'
IDFAVE = 'Id del Articulo Detalle de Ventas'
